8
8
########
#..#..$#
##..#..#
##.#..##
#......#
##.#...#
#....#.#
########