5
6
#####
#..$#
#.###
#..##
#.###
#####