7
6
#######
#....$#
#.#####
#....##
#.#####
#######