9
9
#########
#......$#
#..#.##.#
#.#.....#
#...##..#
#.#.#..##
#.#..#..#
#.....#.#
#########