6
6
######
#...$#
#.####
#...##
#.####
######