8
8
########
#$....##
####.###
####.###
##....##
##.##.##
###....#
########